
SO ./img/so_wall.xpm
NO ./img/no_wall.xpm

WE ./img/we_wall.xpm
EA ./img/ea_wall.xpm

F 255,244,11
C 225,224,255
C 225,224,255

111111
10 001
100S01
100001
100001
111111
