
SO ./img/so_wall.xpm    a 
NO ./img/no_wall.xpm    1

WE ./img/we_wall.xpm    234   
EA ./img/ea_wall.xpm      asdf

F 255,244,11
C 225,224,255

111111
100001
100S01
100001
100001
111111
